5
6
1 1 1 1 1 0
0 0 1 0 1 0
0 0 1 1 1 0
0 0 1 0 0 0
0 1 1 1 1 1

Output:

Backtracking:
1 1 1 1 1 0
0 0 0 0 1 0
0 0 1 1 1 0
0 0 1 0 0 0
0 0 1 1 1 1

Branch and bound:
1 1 1 0 0 0
0 0 1 0 0 0
0 0 1 0 0 0
0 0 1 0 0 0
0 0 1 1 1 1